B A X O M D L C W Y Z M
D A C C Z W M X V Y X A
X W O O M O N E Y Y Z N
B A B R E S O U R C E A
L L O O N F X Y M N O G
R L G F I N A N C E X E
X E B R E W A R D X Y M
L T R A N I N G R A B E
G Y U M O V V W O M L N
X Y R G R G M A B O L T
G L M N O P Q R L D E X
Y E N G I N E E R I N G